...........#...#.......#.#.....#.........#.#...#.....#.#.......#...#.#
##########.#.#.#.#######.#.#####.#####.###.#.###.#####.#.#.#####.###.#
...........#.#.#.....................#...#.#.....#.......#.#.#.#.#...#
####.#.###.#.###.###.#####################.#.#####.#.#.#####.#.#.#.###
.#...#.#...........#.......#.....................#.#.#...#.#.......#.#
.###.#####.#.#####.#######.#.#####################.#######.#.#######.#
.....#.....#...#.........#.......................#.....#.#.......#.#.#
.#.#.#.#.###.###.#############.#########.#########.###.#.#.#######.#.#
.#.#.#.#.#.....#.............#.........#.......#.#.#.#.........#.....#
.#.#.#.#####.###.#.#.#.###.#####.#####.#.#######.#.#.###########.###.#
.#.#.#.#.......#.#.#.#...#.....#.#...#.#.#.........#...............#.#
.#.#.#.#.###.#.#.#.#.###.###.#.###.###.###.#.###.###.###########.#.###
.#.#.#.#...#.#.#.#.#...#...#.#.#.....#.....#...#...............#.#...#
.#.#.#.#.#.#####.#.#.###.#.#.###.#########.#####.###############.#####
.#.#.#.#.#.#.....#.#...#.#.#...........#.....#.#...............#.#.#.#
.###.#.#.#.#####.###.#########.###########.#.#.#.###.#############.#.#
...#.#.#.#.#.......#.......#.......#.....#.#...#...#...#...#.....#...#
.###.#.#.#.#.#.#.#.###.###.#.###.###.#.###.#.#.#.#####.#.###.#####.###
.#...#.#.#.#.#.#.#.#.....#.#...#.....#.#.#.#.#.#.....#...............#
######.#.#.###.#####.#.###.#.#.#.#.#.###.#.###.###########.#.#.#.#.#.#
.......#.#.#.......#.#.#...#.#.#.#.#.....#...#...........#.#.#.#.#.#.#
.#####.#.#.###.#######.#.#.#.#.#.#.#.#.#.#####.#.#.#.#.#.#.#.#.#.#####
.#.....#.#.#.........#.#.#.#.#.#.#.#.#.#.#...#.#.#.#.#.#.#.#.#.#.....#
.#.###.#.#.#.#.###.#.#.#.#######.###.#.#.#.#.###.#####.#.#.###.#.###.#
.#.#...#.#.#.#...#.#.#.#...#.......#.#.#...#...#.....#.#.#...#.#...#.#
.###.#######.#.#########.###########.#.#.#####.#.#.#.###.#####.#.#.#.#
...#...#.....#.........#.........#...#.#...#...#.#.#...#...#...#.#.#.#
.#####.#.#.#.#.#.#####.#################.#.#.###.#########.###.#.###.#
.....#.#.#.#.#.#.....#.............#...#.#.#...#.........#.#...#...#.#
.###.#.#.#.###.#.###########.#.#.###.###.#######.#.#.#####.#.#.#.#.#.#
...#.#.#.#.#...#...........#.#.#.......#.......#.#.#.....#.#.#.#.#.#.#
.###.#.###.#.###.#.#.###.###.#.#.#.#########.#####.#.#####.#.#.#.#.#.#
...#.#.#...#.#...#.#.#.....#.#.#.#.......#.......#.#.....#.#.#.#.#.#.#
.###########.#.#.#.###.#.#######.#.#####.#.#.#.#.###.#.#.###.#####.###
...#.........#.#.#...#.#.....#...#.....#.#.#.#.#...#.#.#...#.#.#...#.#
.#######.###.#.###.#.#####.#####.#.#.###.###.#.#.###.#.#####.#.###.#.#
...#.#...#...#.#...#.....#.....#.#.#...#.#...#.#...#.#...#.......#...#
.###.#########.###.###.#.#.#.#########.###.#.#.#.###.#####.#.#.#.###.#
.#.............#.....#.#.#.#.........#...#.#.#.#...#.....#.#.#.#...#.#
######################################################################
