.#...#...#.#...#.#.........#
.###.###.#.###.#.#####.#.###
.#...........#.........#...#
.#######.###.###.#.#.#.#.#.#
.........#.......#.#.#.#.#.#
##########.###.#.#####.#.#.#
...#.......#...#.#.#...#.#.#
##.#########.###.#.#.###.#.#
.............#...#...#...#.#
########.###.#####.#####.#.#
.........#...#.#...#.....#.#
##########.###.#.###.#.#.###
...........#.......#.#.#...#
############.###.###.#.#.###
...............#...#.#.#...#
############################
